//MAP CONVERTED BY dmm2tgm.py THIS HEADER COMMENT PREVENTS RECONVERSION, DO NOT REMOVE
"ad" = (
/obj/effect/turf_decal/tile/neutral/diagonal_centre,
/obj/effect/turf_decal/tile/neutral/diagonal_edge,
/obj/effect/decal/cleanable/dirt,
/turf/open/floor/iron/dark/diagonal,
/area/shuttle/blackmarket_chevvy)
"bu" = (
/obj/machinery/atmospherics/pipe/smart/manifold4w/supply/hidden/layer4,
/obj/effect/decal/cleanable/dirt,
/turf/open/floor/iron/shuttle/cargo,
/area/shuttle/blackmarket_chevvy)
"cL" = (
/obj/machinery/atmospherics/pipe/smart/manifold4w/supply/hidden/layer4,
/obj/machinery/atmospherics/pipe/smart/manifold4w/scrubbers/hidden/layer2,
/obj/effect/decal/cleanable/dirt,
/turf/open/floor/iron/shuttle/cargo,
/area/shuttle/blackmarket_chevvy)
"en" = (
/obj/machinery/atmospherics/components/unary/vent_pump/on/layer4{
	dir = 8
	},
/obj/effect/decal/cleanable/dirt,
/turf/open/floor/iron/shuttle/cargo,
/area/shuttle/blackmarket_chevvy)
"dM" = (
/obj/structure/shuttle/engine/propulsion/burst,
/turf/open/floor/plating,
/area/shuttle/blackmarket_chevvy)
"eu" = (
/obj/effect/turf_decal/stripes/line{
	dir = 4
	},
/obj/effect/turf_decal/stripes/line{
	dir = 8
	},
/obj/structure/fans/tiny/forcefield{
	dir = 4
	},
/obj/machinery/door/poddoor{
	id = "skiffcargo"
	},
/obj/structure/fluff/metalpole/end{
	dir = 4;
	pixel_x = 32
	},
/turf/open/floor/engine,
/area/shuttle/blackmarket_chevvy)
"fp" = (
/turf/closed/wall/mineral/titanium,
/area/shuttle/blackmarket_chevvy)
"jD" = (
/obj/effect/turf_decal/delivery/white,
/obj/machinery/door/airlock/external,
/obj/machinery/atmospherics/pipe/smart/manifold4w/supply/hidden/layer4,
/obj/machinery/atmospherics/pipe/smart/manifold4w/scrubbers/hidden/layer2,
/obj/effect/mapping_helpers/airlock/cyclelink_helper_multi{
	cycle_id = "skiffside"
	},
/turf/open/floor/iron/dark/textured_large,
/area/shuttle/blackmarket_chevvy)
"ka" = (
/obj/machinery/portable_atmospherics/canister/oxygen,
/obj/machinery/atmospherics/components/unary/portables_connector/visible/layer4{
	dir = 4
	},
/obj/machinery/atmospherics/pipe/smart/manifold4w/scrubbers/hidden/layer2,
/obj/effect/turf_decal/bot_white,
/turf/open/floor/iron/dark/smooth_large,
/area/shuttle/blackmarket_chevvy)
"nB" = (
/obj/machinery/atmospherics/pipe/smart/manifold4w/supply/hidden/layer4,
/obj/machinery/atmospherics/components/unary/vent_scrubber/on/layer2{
	dir = 8
	},
/obj/effect/decal/cleanable/dirt,
/turf/open/floor/iron/shuttle/cargo,
/area/shuttle/blackmarket_chevvy)
"lB" = (
/obj/structure/chair/comfy/shuttle{
	dir = 4
	},
/obj/structure/window/reinforced/spawner,
/obj/effect/decal/cleanable/dirt/dust,
/turf/open/floor/iron,
/area/shuttle/blackmarket_chevvy)
"qx" = (
/obj/effect/decal/cleanable/dirt/dust,
/turf/open/floor/plating,
/area/shuttle/blackmarket_chevvy)
"rw" = (
/obj/machinery/door/window{
	req_access_txt = "208"
	},
/turf/closed/wall/mineral/titanium/nodiagonal,
/area/shuttle/blackmarket_chevvy)
"uW" = (
/obj/machinery/power/shuttle_engine/heater{
	dir = 8
	},
/turf/open/floor/mineral/titanium,
/area/shuttle/blackmarket_chevvy)
"zl" = (
/obj/effect/decal/cleanable/dirt/dust,
/obj/structure/shuttle/engine/heater,
/obj/machinery/atmospherics/pipe/smart/manifold4w/orange/visible,
/turf/open/floor/plating,
/area/shuttle/blackmarket_chevvy)
"Dx" = (
/turf/open/floor/plating,
/area/shuttle/blackmarket_chevvy)
"Dy" = (
/obj/structure/window/reinforced/spawner,
/obj/machinery/computer/shuttle/caravan/blackmarket_chevvy{
	dir = 8
	},
/turf/open/floor/plating,
/area/shuttle/blackmarket_chevvy)
"Hj" = (
/obj/structure/chair/comfy/shuttle{
	dir = 4
	},
/turf/open/floor/mineral/titanium,
/area/shuttle/blackmarket_chevvy)
"Pb" = (
/obj/effect/spawner/structure/window/reinforced/shuttle,
/turf/open/floor/plating,
/area/shuttle/blackmarket_chevvy)
"RU" = (
/obj/machinery/computer/camera_advanced/shuttle_docker/blackmarket_chevvy{
	dir = 8
	},
/turf/open/floor/iron,
/area/shuttle/blackmarket_chevvy)
"SN" = (
/obj/effect/decal/cleanable/dirt/dust,
/obj/machinery/atmospherics/components/unary/portables_connector/visible,
/obj/machinery/portable_atmospherics/canister/carbon_dioxide,
/turf/open/floor/mineral/titanium,
/area/shuttle/blackmarket_chevvy)
"Ut" = (
/obj/structure/chair/comfy/shuttle{
	dir = 4
	},
/turf/open/floor/plating,
/area/shuttle/blackmarket_chevvy)
"Vy" = (
/obj/machinery/light{
	dir = 4
	},
/obj/effect/decal/cleanable/dirt/dust,
/turf/open/floor/mineral/titanium,
/area/shuttle/blackmarket_chevvy)
"XU" = (
/obj/docking_port/mobile{
	callTime = 50;
	dir = 4;
	dwidth = 4;
	height = 5;
	id = "blackmarket_chevvy";
	ignitionTime = 25;
	name = "Chevvy";
	port_direction = 2;
	preferred_direction = 4;
	width = 9
	},
/obj/machinery/button/door/directional/south{
	id = "skiffcargo";
	name = "Blast Door Control"
	},
/obj/effect/decal/cleanable/dirt,
/turf/open/floor/iron/shuttle/cargo,
/area/shuttle/blackmarket_chevvy)
"zi" = (
/obj/effect/turf_decal/stripes/line{
	dir = 8
	},
/obj/machinery/atmospherics/components/unary/passive_vent/layer2{
	dir = 4
	},
/obj/structure/fluff/metalpole/end{
	dir = 8;
	pixel_x = -32
	},
/obj/machinery/power/shuttle_engine/propulsion{
	dir = 8
	},
/turf/open/floor/plating/airless,
/area/shuttle/blackmarket_chevvy)
"zH" = (
/obj/machinery/button/door/directional/north{
	id = "skiffexts";
	name = "External Airlock Bolt Control";
	normaldoorcontrol = 1;
	specialfunctions = 4
	},
/obj/machinery/atmospherics/pipe/smart/manifold4w/supply/hidden/layer4,
/obj/machinery/atmospherics/pipe/smart/manifold4w/scrubbers/hidden/layer2,
/turf/open/floor/catwalk_floor,
/area/shuttle/blackmarket_chevvy)
"Yw" = (
/obj/effect/decal/cleanable/dirt/dust,
/obj/machinery/atmospherics/pipe/smart/manifold4w/orange/visible,
/turf/open/floor/mineral/titanium,
/area/shuttle/blackmarket_chevvy)
"YP" = (
/obj/effect/turf_decal/delivery/white,
/obj/machinery/door/airlock/external{
	id_tag = "skiffextb"
	},
/obj/effect/mapping_helpers/airlock/cyclelink_helper{
	dir = 4
	},
/turf/open/floor/iron/dark/smooth_large,
/area/shuttle/blackmarket_chevvy)
"ZI" = (
/obj/structure/chair/comfy/shuttle{
	dir = 8
	},
/obj/effect/decal/cleanable/dirt/dust,
/turf/open/floor/mineral/titanium,
/area/shuttle/blackmarket_chevvy)

(1,1,1) = {"
fp
fp
fp
Pb
XU
Pb
fp
fp
fp
"}
(2,1,1) = {"
fp
YP
rw
uW
fh
Ut
Hj
zl
dM
"}
(3,1,1) = {"
Pb
eu
lB
kT
qx
bY
Dx
Yw
Pb
"}
(4,1,1) = {"
fp
RU
Dy
uW
Vy
ZI
SN
zl
dM
"}
(5,1,1) = {"
fp
Pb
Pb
Pb
fp
Pb
Pb
Pb
fp
"}
